+++++++++++++++++++++++++++++
++++++  d             f  ++++
++++++  d                ++++
+++++++++++++++s+++++++++++++
+++++++++++++++s+++++++++++++
++++           s         ++++
+++ +++   ++++ s ++++++  ++++
+++++++++++++++++++++++++++++
